0000000004
1100011000
1000000000
1111111000
0000150000
1100151000
0000111000
1100011020
3000000000
1100011000
